
;= Git Commands
ga=git add --all .
gb=git branch $*
gc=git commit
gcout=git checkout $*
gd=git diff --ignore-space-change HEAD $*
gf=git fetch
gl=git log $*
gm=git merge $*
gpl=git pull
gps=git push
gr=git remote -v
grevert=git reset --hard HEAD
grevertfile=git checkout HEAD $*
gs=git status $*
gunadd=git reset --keep $*
gunstash=git stash apply $*

;= standard renames
ll=ls -l
lla=ls -la
open=explorer .

;= Program Shortcuts
iis=%windir%\system32\inetsrv\InetMgr.exe
remember=gvim %userprofile%\Documents\GitHub\Windows-Aliases\stuff.txt
acronym=gvim %userprofile%\Documents\GitHub\Windows-Aliases\acronyms.txt
quirk=gvim %userprofile%\Documents\GitHub\Windows-Aliases\quirks.txt

;= Edit Setting files
bashrc=gvim %userprofile%\Documents\GitHub\Windows-Aliases\mymacros.txt
hosts=gvim %windir%\System32\drivers\etc\hosts
vimrc=gvim "c:\Program Files (x86)\Vim\_vimrc"

;= directory shortcuts 
home=cd /d %userprofile%
documents=cd /d %userprofile%\Documents
downloads=cd /d %userprofile%\Downloads
gh=cd /d %userprofile%\Documents\GitHub

;= Repositories
acme=cd /d %userprofile%\Documents\GitHub\Acme.Site
als=cd /d %userprofile%\Documents\GitHub\ArtificialLift
babel=cd /d %userprofile%\Documents\GitHub\BabelFish
brazil=cd /d %userprofile%\Documents\GitHub\BrazilWS
china=cd /d %userprofile%\Documents\GitHub\ChinaWS
corp=cd /d %userprofile%\Documents\GitHub\Corp
crop=cd /d %userprofile%\Documents\GitHub\ImageCropper
emena=cd /d %userprofile%\Documents\GitHub\EMENA
ff=cd /d %userprofile%\Documents\GitHub\FranklinFueling
fp2=cd /d %userprofile%\Documents\GitHub\FranklinPro2
fp=cd /d %userprofile%\Documents\GitHub\FranklinPro
fpsbr=cd /d %userprofile%\Documents\GitHub\BrazilFPS
head=cd /d %userprofile%\Documents\GitHub\Headwater
ignore=cd /d %userprofile%\Documents\GitHub\gitignore
incon=cd /d %userprofile%\Documents\GitHub\Incon
la=cd /d %userprofile%\Documents\GitHub\Latin.America
leao=cd /d %userprofile%\Documents\GitHub\Leao
lg=cd /d %userprofile%\Documents\GitHub\Little-Giant
lge=cd /d %userprofile%\Documents\GitHub\LG.engineered
merch=cd /d %userprofile%\Documents\GitHub\RosettaStone\src
naws=cd /d %userprofile%\Documents\GitHub\NAWS
oln=cd /d %userprofile%\Documents\GitHub\OutdoorLiving
pp2=cd /d %userprofile%\Documents\GitHub\PioneerLive
pp=cd /d %userprofile%\Documents\GitHub\Pioneerpump.com
resizer=cd /d %userprofile%\Documents\GitHub\resizer
rl=cd /d %userprofile%\Documents\GitHub\RedLion
sa=cd /d %userprofile%\Documents\GitHub\South-Africa
schn=cd /d %userprofile%\Documents\GitHub\Schneider
scone=cd /d %userprofile%\Documents\GitHub\SouthernCone
settings=cd /d %userprofile%\Documents\GitHub\Windows-Aliases
seven=cd /d %userprofile%\Documents\GitHub\Umbraco7
solar=cd /d %userprofile%\Documents\GitHub\Solar
uni=cd /d %userprofile%\Documents\GitHub\FFSPRO-University

;= :end
;= rem ******************************************************************
;= rem * EOF - Don't remove the following line.  It clears out the ';' 
;= rem * macro. We are using it because there is no support for comments
;= rem * in a DOSKEY macro file.
;= rem ******************************************************************
;=
